30
16
0	0	0	0	0	0	0	0	0	0	0	0	0	0	0	0	0	0	0	0	0	0	0	0	0	0	0	0	0	0
0	0	0	0	0	0	0	0	0	0	0	0	0	0	0	0	0	0	0	0	0	0	0	0	0	0	0	0	0	0
0	0	0	0	0	0	0	0	0	0	3	4	0	0	0	0	0	0	0	0	2	0	0	0	0	0	0	0	0	0
0	0	0	0	0	0	0	0	0	0	0	0	0	0	0	0	0	0	0	0	0	0	0	0	0	0	0	0	0	0
0	0	0	0	0	0	3	5	4	0	0	0	0	0	0	3	4	0	0	0	0	0	0	3	4	0	0	0	0	0
3	5	5	4	0	0	0	0	0	0	0	0	0	0	0	0	0	0	0	0	1	0	0	0	0	0	0	0	0	0
0	0	0	0	0	0	0	0	0	0	0	0	0	0	0	0	0	0	0	0	6	0	0	0	3	4	0	0	0	0
0	0	0	0	0	0	0	0	0	0	0	0	2	0	2	0	0	0	0	3	7	4	0	0	0	0	0	0	0	0
0	0	0	0	0	2	0	3	4	0	0	0	0	0	0	0	0	0	0	0	0	0	0	0	0	0	2	0	0	0
0	0	0	0	0	0	0	0	0	0	0	2	0	0	0	2	0	0	0	0	0	0	0	0	0	0	0	0	0	0
0	0	0	0	0	0	0	0	0	0	0	0	3	5	4	0	0	0	1	0	0	0	0	0	0	0	0	0	2	0
0	0	0	1	0	0	0	3	4	0	0	0	0	0	0	0	0	3	7	5	4	0	0	2	0	0	0	0	0	0
0	0	3	7	4	0	0	0	0	0	0	0	0	0	0	0	0	0	0	0	0	0	0	0	0	0	0	0	0	0
0	0	0	0	0	0	0	0	0	0	2	0	0	3	5	4	0	0	0	0	0	0	0	0	0	0	3	4	0	0
0	0	0	0	0	0	3	5	4	0	0	0	0	0	0	0	0	0	0	0	0	2	0	2	0	0	0	0	0	0
0	0	0	0	0	0	0	0	0	0	0	0	0	0	0	0	0	0	0	0	0	0	0	0	0	0	0	0	0	0